...###
..##@#.####
.##..###..#
##........#
#...#..#..#
###..###..#
..#..#....#
.##.##.#.##
.#.....##
.#.....##
.#######